51  51  
2  2  
52  2  
2  52  
52  52  
-1   -1   -1   -1   -1   -1   -1   -1   -1   -1   -1   -1   -1   -1   -1   -1   -1   -1   -1   -1   -1   -1   -1   -1   -1   -1   -1   -1   -1   -1   -1   -1   -1   -1   -1   -1   -1   -1   -1   -1   -1   -1   -1   -1   -1   -1   -1   -1   -1   -1   -1   -1   -1   -1   -1   
-1   -1   -1   -1   -1   -1   -1   -1   -1   -1   -1   -1   -1   -1   -1   -1   -1   -1   -1   -1   -1   -1   -1   -1   -1   -1   -1   -1   -1   -1   -1   -1   -1   -1   -1   -1   -1   -1   -1   -1   -1   -1   -1   -1   -1   -1   -1   -1   -1   -1   -1   -1   -1   -1   -1   
-1   -1   0   1   0   0   0   0   0   0   0   0   0   1   0   0   0   1   0   0   0   0   0   0   0   0   0   1   0   0   0   1   0   0   0   0   0   0   0   0   0   0   0   1   0   0   0   0   0   0   0   1   0   -1   -1   
-1   -1   0   -1   1   -1   0   -1   1   -1   1   -1   0   -1   0   -1   0   -1   0   -1   1   -1   0   -1   1   -1   0   -1   1   -1   0   -1   0   -1   1   -1   0   -1   1   -1   1   -1   1   -1   0   -1   1   -1   0   -1   0   -1   0   -1   -1   
-1   -1   0   0   0   0   0   1   0   0   0   1   0   0   0   1   0   1   0   1   0   0   0   1   0   0   0   0   0   0   0   1   0   0   0   1   0   0   0   1   0   0   0   0   0   0   0   1   0   1   0   1   0   -1   -1   
-1   -1   1   -1   1   -1   1   -1   0   -1   1   -1   1   -1   1   -1   0   -1   0   -1   0   -1   1   -1   1   -1   1   -1   1   -1   0   -1   1   -1   0   -1   1   -1   0   -1   0   -1   1   -1   1   -1   1   -1   0   -1   0   -1   0   -1   -1   
-1   -1   0   0   0   1   0   0   0   1   0   0   0   0   0   0   0   1   0   1   0   0   0   0   0   1   0   0   0   1   0   0   0   1   0   1   0   1   0   0   0   1   0   1   0   0   0   0   0   1   0   1   0   -1   -1   
-1   -1   0   -1   1   -1   0   -1   0   -1   0   -1   1   -1   1   -1   1   -1   1   -1   1   -1   1   -1   0   -1   0   -1   1   -1   1   -1   0   -1   0   -1   0   -1   1   -1   1   -1   0   -1   0   -1   0   -1   1   -1   1   -1   0   -1   -1   
-1   -1   0   1   0   0   0   1   0   0   0   0   0   0   0   0   0   1   0   0   0   1   0   0   0   1   0   1   0   0   0   1   0   1   0   1   0   0   0   0   0   1   0   1   0   1   0   1   0   0   0   0   0   -1   -1   
-1   -1   0   -1   0   -1   1   -1   0   -1   1   -1   1   -1   1   -1   0   -1   0   -1   0   -1   0   -1   1   -1   0   -1   0   -1   0   -1   0   -1   0   -1   0   -1   1   -1   0   -1   0   -1   0   -1   1   -1   0   -1   1   -1   1   -1   -1   
-1   -1   0   1   0   0   0   1   0   0   0   1   0   0   0   1   0   1   0   1   0   1   0   0   0   1   0   0   0   1   0   0   0   1   0   0   0   1   0   1   0   1   0   1   0   0   0   0   0   1   0   0   0   -1   -1   
-1   -1   0   -1   0   -1   1   -1   0   -1   0   -1   0   -1   0   -1   0   -1   0   -1   0   -1   1   -1   0   -1   0   -1   1   -1   1   -1   1   -1   1   -1   1   -1   0   -1   0   -1   0   -1   1   -1   1   -1   1   -1   0   -1   0   -1   -1   
-1   -1   0   0   0   1   0   0   0   1   0   0   0   1   0   1   0   1   0   1   0   0   0   1   0   1   0   0   0   0   0   0   0   1   0   0   0   0   0   1   0   1   0   0   0   1   0   0   0   0   0   1   0   -1   -1   
-1   -1   1   -1   1   -1   0   -1   1   -1   1   -1   1   -1   0   -1   0   -1   0   -1   1   -1   0   -1   0   -1   1   -1   1   -1   1   -1   0   -1   0   -1   1   -1   1   -1   0   -1   0   -1   1   -1   0   -1   1   -1   1   -1   0   -1   -1   
-1   -1   0   0   0   0   0   1   0   0   0   1   0   0   0   1   0   1   0   1   0   1   0   0   0   1   0   0   0   1   0   0   0   0   0   0   0   0   0   1   0   1   0   1   0   0   0   1   0   0   0   0   0   -1   -1   
-1   -1   0   -1   1   -1   1   -1   0   -1   0   -1   0   -1   1   -1   0   -1   0   -1   0   -1   1   -1   1   -1   0   -1   0   -1   0   -1   1   -1   0   -1   1   -1   0   -1   0   -1   0   -1   0   -1   1   -1   0   -1   1   -1   0   -1   -1   
-1   -1   0   0   0   1   0   0   0   1   0   1   0   1   0   0   0   1   0   1   0   0   0   0   0   0   0   1   0   1   0   0   0   1   0   1   0   0   0   1   0   1   0   0   0   0   0   1   0   1   0   0   0   -1   -1   
-1   -1   1   -1   0   -1   0   -1   0   -1   1   -1   0   -1   0   -1   1   -1   0   -1   0   -1   0   -1   1   -1   1   -1   1   -1   1   -1   0   -1   1   -1   0   -1   0   -1   0   -1   0   -1   1   -1   1   -1   0   -1   0   -1   1   -1   -1   
-1   -1   0   0   0   1   0   1   0   1   0   0   0   1   0   0   0   1   0   1   0   1   0   1   0   0   0   1   0   0   0   1   0   0   0   1   0   1   0   1   0   1   0   0   0   1   0   0   0   1   0   1   0   -1   -1   
-1   -1   0   -1   1   -1   0   -1   1   -1   0   -1   1   -1   1   -1   0   -1   0   -1   0   -1   0   -1   0   -1   0   -1   0   -1   0   -1   1   -1   0   -1   0   -1   1   -1   0   -1   1   -1   1   -1   0   -1   1   -1   0   -1   0   -1   -1   
-1   -1   0   1   0   0   0   0   0   1   0   0   0   1   0   0   0   1   0   1   0   1   0   0   0   1   0   0   0   1   0   1   0   0   0   1   0   0   0   1   0   0   0   1   0   0   0   1   0   0   0   0   0   -1   -1   
-1   -1   0   -1   1   -1   0   -1   0   -1   1   -1   0   -1   0   -1   1   -1   0   -1   0   -1   1   -1   1   -1   1   -1   1   -1   0   -1   0   -1   1   -1   1   -1   0   -1   1   -1   0   -1   0   -1   1   -1   1   -1   1   -1   0   -1   -1   
-1   -1   0   0   0   1   0   1   0   0   0   0   0   1   0   0   0   0   0   1   0   1   0   0   0   0   0   0   0   0   0   1   0   1   0   0   0   1   0   0   0   1   0   1   0   1   0   0   0   0   0   1   0   -1   -1   
-1   -1   1   -1   0   -1   1   -1   1   -1   1   -1   1   -1   1   -1   1   -1   1   -1   0   -1   0   -1   1   -1   1   -1   1   -1   0   -1   0   -1   1   -1   0   -1   0   -1   1   -1   0   -1   0   -1   0   -1   1   -1   0   -1   0   -1   -1   
-1   -1   0   1   0   0   0   0   0   0   0   0   0   0   0   0   0   1   0   1   0   1   0   0   0   0   0   0   0   1   0   1   0   0   0   0   0   1   0   0   0   1   0   1   0   0   0   1   0   1   0   1   0   -1   -1   
-1   -1   0   -1   1   -1   1   -1   1   -1   1   -1   1   -1   1   -1   0   -1   0   -1   0   -1   1   -1   1   -1   1   -1   0   -1   0   -1   1   -1   1   -1   0   -1   0   -1   0   -1   0   -1   0   -1   1   -1   0   -1   0   -1   1   -1   -1   
-1   -1   0   0   0   0   0   0   0   0   0   1   0   1   0   0   0   1   0   0   0   0   0   0   0   1   0   0   0   1   0   1   0   1   0   0   0   1   0   1   0   1   0   1   0   0   0   0   0   1   0   0   0   -1   -1   
-1   -1   0   -1   1   -1   1   -1   0   -1   0   -1   0   -1   0   -1   1   -1   1   -1   1   -1   1   -1   1   -1   0   -1   1   -1   0   -1   0   -1   0   -1   1   -1   0   -1   0   -1   0   -1   1   -1   0   -1   1   -1   1   -1   0   -1   -1   
-1   -1   0   1   0   0   0   1   0   1   0   0   0   1   0   0   0   0   0   0   0   0   0   1   0   0   0   1   0   1   0   0   0   1   0   0   0   1   0   1   0   0   0   1   0   1   0   1   0   0   0   1   0   -1   -1   
-1   -1   0   -1   0   -1   0   -1   0   -1   1   -1   1   -1   1   -1   1   -1   1   -1   1   -1   0   -1   0   -1   1   -1   0   -1   0   -1   1   -1   1   -1   0   -1   0   -1   1   -1   1   -1   0   -1   0   -1   0   -1   0   -1   0   -1   -1   
-1   -1   0   1   0   1   0   0   0   1   0   0   0   0   0   0   0   1   0   1   0   0   0   1   0   1   0   0   0   0   0   1   0   0   0   0   0   1   0   0   0   0   0   1   0   0   0   1   0   1   0   0   0   -1   -1   
-1   -1   0   -1   0   -1   1   -1   1   -1   0   -1   0   -1   1   -1   0   -1   0   -1   0   -1   1   -1   0   -1   1   -1   1   -1   1   -1   0   -1   1   -1   1   -1   1   -1   1   -1   0   -1   0   -1   1   -1   0   -1   1   -1   1   -1   -1   
-1   -1   0   1   0   0   0   0   0   0   0   1   0   1   0   0   0   0   0   1   0   1   0   0   0   0   0   1   0   0   0   0   0   1   0   0   0   1   0   0   0   0   0   1   0   1   0   1   0   0   0   0   0   -1   -1   
-1   -1   0   -1   1   -1   1   -1   1   -1   1   -1   0   -1   1   -1   1   -1   1   -1   0   -1   1   -1   1   -1   0   -1   0   -1   1   -1   1   -1   0   -1   1   -1   0   -1   1   -1   1   -1   0   -1   0   -1   1   -1   1   -1   0   -1   -1   
-1   -1   0   0   0   0   0   0   0   1   0   1   0   0   0   0   0   0   0   1   0   0   0   0   0   1   0   1   0   0   0   1   0   0   0   1   0   0   0   1   0   0   0   0   0   0   0   1   0   0   0   0   0   -1   -1   
-1   -1   1   -1   1   -1   1   -1   0   -1   0   -1   1   -1   1   -1   1   -1   0   -1   1   -1   1   -1   0   -1   0   -1   1   -1   0   -1   0   -1   1   -1   0   -1   1   -1   0   -1   1   -1   1   -1   1   -1   0   -1   1   -1   1   -1   -1   
-1   -1   0   0   0   0   0   1   0   1   0   0   0   0   0   0   0   1   0   0   0   1   0   1   0   1   0   0   0   0   0   1   0   0   0   1   0   1   0   0   0   1   0   0   0   0   0   1   0   0   0   0   0   -1   -1   
-1   -1   0   -1   0   -1   0   -1   0   -1   0   -1   1   -1   1   -1   0   -1   0   -1   0   -1   0   -1   0   -1   0   -1   1   -1   1   -1   0   -1   0   -1   0   -1   1   -1   1   -1   0   -1   1   -1   0   -1   1   -1   1   -1   0   -1   -1   
-1   -1   0   1   0   1   0   1   0   1   0   1   0   0   0   0   0   1   0   1   0   1   0   1   0   1   0   1   0   1   0   0   0   1   0   1   0   0   0   0   0   1   0   1   0   0   0   0   0   0   0   1   0   -1   -1   
-1   -1   0   -1   0   -1   1   -1   0   -1   0   -1   0   -1   1   -1   1   -1   0   -1   0   -1   0   -1   0   -1   0   -1   0   -1   0   -1   1   -1   0   -1   1   -1   1   -1   0   -1   0   -1   1   -1   1   -1   1   -1   0   -1   0   -1   -1   
-1   -1   0   1   0   0   0   0   0   0   0   1   0   0   0   0   0   1   0   1   0   0   0   1   0   1   0   0   0   1   0   1   0   1   0   0   0   0   0   0   0   1   0   0   0   0   0   0   0   1   0   0   0   -1   -1   
-1   -1   0   -1   1   -1   1   -1   0   -1   1   -1   1   -1   1   -1   1   -1   0   -1   1   -1   1   -1   0   -1   0   -1   1   -1   0   -1   0   -1   1   -1   1   -1   1   -1   1   -1   1   -1   1   -1   1   -1   0   -1   1   -1   1   -1   -1   
-1   -1   0   1   0   0   0   1   0   1   0   0   0   0   0   1   0   0   0   1   0   0   0   0   0   1   0   1   0   0   0   1   0   0   0   0   0   0   0   0   0   1   0   0   0   0   0   1   0   0   0   0   0   -1   -1   
-1   -1   1   -1   0   -1   0   -1   0   -1   0   -1   1   -1   0   -1   0   -1   0   -1   0   -1   1   -1   1   -1   0   -1   0   -1   1   -1   0   -1   1   -1   1   -1   1   -1   0   -1   0   -1   1   -1   0   -1   1   -1   0   -1   0   -1   -1   
-1   -1   0   0   0   1   0   1   0   1   0   1   0   0   0   0   0   1   0   1   0   0   0   1   0   1   0   1   0   0   0   0   0   1   0   0   0   0   0   1   0   0   0   1   0   1   0   0   0   1   0   1   0   -1   -1   
-1   -1   0   -1   1   -1   0   -1   0   -1   0   -1   1   -1   1   -1   1   -1   0   -1   1   -1   0   -1   0   -1   0   -1   1   -1   0   -1   1   -1   0   -1   1   -1   0   -1   1   -1   1   -1   0   -1   1   -1   0   -1   0   -1   0   -1   -1   
-1   -1   0   1   0   0   0   1   0   1   0   0   0   0   0   1   0   1   0   0   0   1   0   1   0   0   0   1   0   0   0   0   0   0   0   0   0   1   0   0   0   0   0   0   0   0   0   1   0   1   0   1   0   -1   -1   
-1   -1   0   -1   1   -1   0   -1   1   -1   1   -1   1   -1   0   -1   0   -1   1   -1   0   -1   0   -1   1   -1   1   -1   0   -1   1   -1   1   -1   1   -1   0   -1   1   -1   1   -1   1   -1   1   -1   0   -1   0   -1   1   -1   0   -1   -1   
-1   -1   0   0   0   1   0   1   0   0   0   1   0   0   0   1   0   1   0   0   0   0   0   1   0   0   0   0   0   1   0   0   0   0   0   1   0   1   0   0   0   1   0   0   0   0   0   1   0   0   0   1   0   -1   -1   
-1   -1   1   -1   0   -1   0   -1   0   -1   0   -1   0   -1   1   -1   0   -1   0   -1   1   -1   0   -1   0   -1   1   -1   1   -1   0   -1   1   -1   0   -1   0   -1   1   -1   0   -1   0   -1   1   -1   1   -1   1   -1   0   -1   0   -1   -1   
-1   -1   0   0   0   1   0   1   0   1   0   1   0   1   0   0   0   1   0   0   0   1   0   1   0   1   0   0   0   0   0   1   0   1   0   1   0   0   0   1   0   0   0   0   0   0   0   0   0   1   0   0   0   -1   -1   
-1   -1   0   -1   1   -1   0   -1   0   -1   0   -1   0   -1   0   -1   1   -1   1   -1   0   -1   0   -1   0   -1   0   -1   1   -1   1   -1   0   -1   0   -1   1   -1   0   -1   1   -1   1   -1   1   -1   1   -1   1   -1   1   -1   1   -1   -1   
-1   -1   0   1   0   0   0   0   0   1   0   0   0   1   0   0   0   0   0   0   0   1   0   0   0   0   0   1   0   0   0   0   0   0   0   0   0   1   0   0   0   0   0   0   0   0   0   0   0   0   0   0   0   -1   -1   
-1   -1   -1   -1   -1   -1   -1   -1   -1   -1   -1   -1   -1   -1   -1   -1   -1   -1   -1   -1   -1   -1   -1   -1   -1   -1   -1   -1   -1   -1   -1   -1   -1   -1   -1   -1   -1   -1   -1   -1   -1   -1   -1   -1   -1   -1   -1   -1   -1   -1   -1   -1   -1   -1   -1   
-1   -1   -1   -1   -1   -1   -1   -1   -1   -1   -1   -1   -1   -1   -1   -1   -1   -1   -1   -1   -1   -1   -1   -1   -1   -1   -1   -1   -1   -1   -1   -1   -1   -1   -1   -1   -1   -1   -1   -1   -1   -1   -1   -1   -1   -1   -1   -1   -1   -1   -1   -1   -1   -1   -1   
