11  11  
2  2  
12  13  
-1   -1   -1   -1   -1   -1   -1   -1   -1   -1   -1   -1   -1   -1   -1   
-1   -1   -1   -1   -1   -1   -1   -1   -1   -1   -1   -1   -1   -1   -1   
-1   -1   10   0   0   1   0   0   0   0   0   0   0   -1   -1   
-1   -1   10   -1   0   -1   1   -1   0   -1   1   -1   0   -1   -1   
-1   -1   10   1   0   0   0   0   0   1   0   0   0   -1   -1   
-1   -1   10   -1   1   -1   1   -1   1   -1   0   -1   1   -1   -1   
-1   -1   10   1   10   10   10   1   0   1   0   1   0   -1   -1   
-1   -1   10   -1   10   -1   10   -1   0   -1   0   -1   0   -1   -1   
-1   -1   10   10   10   1   10   1   0   1   0   1   0   -1   -1   
-1   -1   0   -1   1   -1   10   -1   0   -1   0   -1   0   -1   -1   
-1   -1   0   1   10   10   10   1   0   0   0   0   0   -1   -1   
-1   -1   0   -1   10   -1   1   -1   1   -1   1   -1   1   -1   -1   
-1   -1   0   1   10   10   10   10   10   10   10   10   10   -1   -1   
-1   -1   -1   -1   -1   -1   -1   -1   -1   -1   -1   -1   -1   -1   -1   
-1   -1   -1   -1   -1   -1   -1   -1   -1   -1   -1   -1   -1   -1   -1   
