25  25  
2  2  
26  27  
-1   -1   -1   -1   -1   -1   -1   -1   -1   -1   -1   -1   -1   -1   -1   -1   -1   -1   -1   -1   -1   -1   -1   -1   -1   -1   -1   -1   -1   
-1   -1   -1   -1   -1   -1   -1   -1   -1   -1   -1   -1   -1   -1   -1   -1   -1   -1   -1   -1   -1   -1   -1   -1   -1   -1   -1   -1   -1   
-1   -1   10   0   0   1   0   0   0   0   0   1   0   0   0   0   0   0   0   1   10   10   10   1   10   10   10   -1   -1   
-1   -1   10   -1   0   -1   0   -1   1   -1   0   -1   0   -1   0   -1   1   -1   1   -1   10   -1   10   -1   10   -1   10   -1   -1   
-1   -1   10   1   0   0   0   1   0   1   0   1   0   1   0   0   0   1   10   10   10   1   10   10   10   1   10   -1   -1   
-1   -1   10   -1   1   -1   1   -1   0   -1   0   -1   0   -1   1   -1   0   -1   10   -1   1   -1   1   -1   1   -1   10   -1   -1   
-1   -1   10   10   10   1   0   1   0   0   0   1   0   1   0   0   0   1   10   1   0   0   0   1   10   10   10   -1   -1   
-1   -1   0   -1   10   -1   0   -1   0   -1   1   -1   1   -1   0   -1   1   -1   10   -1   0   -1   1   -1   10   -1   1   -1   -1   
-1   -1   0   1   10   1   0   1   0   0   0   1   0   0   0   1   10   10   10   1   0   0   0   1   10   10   10   -1   -1   
-1   -1   0   -1   10   -1   0   -1   1   -1   0   -1   0   -1   1   -1   10   -1   1   -1   1   -1   0   -1   1   -1   10   -1   -1   
-1   -1   0   1   10   1   0   0   0   1   0   1   0   0   0   1   10   10   10   10   10   10   10   1   10   10   10   -1   -1   
-1   -1   1   -1   10   -1   0   -1   1   -1   0   -1   1   -1   0   -1   1   -1   1   -1   1   -1   10   -1   10   -1   0   -1   -1   
-1   -1   10   10   10   1   0   0   0   1   0   1   0   0   0   0   0   0   0   1   0   1   10   1   10   1   0   -1   -1   
-1   -1   10   -1   1   -1   0   -1   0   -1   0   -1   0   -1   1   -1   1   -1   0   -1   0   -1   10   -1   10   -1   0   -1   -1   
-1   -1   10   1   0   1   0   1   0   0   0   1   0   0   0   0   0   1   0   1   0   1   10   1   10   1   0   -1   -1   
-1   -1   10   -1   0   -1   0   -1   1   -1   1   -1   1   -1   1   -1   0   -1   0   -1   0   -1   10   -1   10   -1   1   -1   -1   
-1   -1   10   1   0   0   0   0   0   0   0   0   0   0   0   1   0   1   0   0   0   1   10   1   10   10   10   -1   -1   
-1   -1   10   -1   1   -1   1   -1   1   -1   1   -1   1   -1   0   -1   0   -1   1   -1   0   -1   10   -1   1   -1   10   -1   -1   
-1   -1   10   10   10   1   0   0   0   0   0   0   0   1   0   0   0   1   0   0   0   1   10   10   10   1   10   -1   -1   
-1   -1   0   -1   10   -1   1   -1   0   -1   1   -1   1   -1   1   -1   1   -1   0   -1   1   -1   1   -1   10   -1   10   -1   -1   
-1   -1   0   1   10   10   10   1   0   1   0   0   0   1   0   0   0   0   0   1   10   10   10   10   10   1   10   -1   -1   
-1   -1   1   -1   1   -1   10   -1   0   -1   0   -1   0   -1   0   -1   1   -1   1   -1   10   -1   1   -1   1   -1   10   -1   -1   
-1   -1   10   10   10   10   10   1   0   0   0   1   0   0   0   1   10   10   10   1   10   10   10   1   10   10   10   -1   -1   
-1   -1   10   -1   1   -1   1   -1   1   -1   1   -1   0   -1   1   -1   10   -1   10   -1   1   -1   10   -1   10   -1   1   -1   -1   
-1   -1   10   10   10   1   10   10   10   10   10   1   0   1   10   10   10   1   10   10   10   1   10   1   10   10   10   -1   -1   
-1   -1   0   -1   10   -1   10   -1   1   -1   10   -1   1   -1   10   -1   1   -1   1   -1   10   -1   10   -1   1   -1   10   -1   -1   
-1   -1   0   1   10   10   10   0   0   1   10   10   10   10   10   0   0   0   0   1   10   10   10   0   0   1   10   -1   -1   
-1   -1   -1   -1   -1   -1   -1   -1   -1   -1   -1   -1   -1   -1   -1   -1   -1   -1   -1   -1   -1   -1   -1   -1   -1   -1   -1   -1   -1   
-1   -1   -1   -1   -1   -1   -1   -1   -1   -1   -1   -1   -1   -1   -1   -1   -1   -1   -1   -1   -1   -1   -1   -1   -1   -1   -1   -1   -1   
