25  25  
2  2  
26  2  
2  26  
26  26  
-1   -1   -1   -1   -1   -1   -1   -1   -1   -1   -1   -1   -1   -1   -1   -1   -1   -1   -1   -1   -1   -1   -1   -1   -1   -1   -1   -1   -1   
-1   -1   -1   -1   -1   -1   -1   -1   -1   -1   -1   -1   -1   -1   -1   -1   -1   -1   -1   -1   -1   -1   -1   -1   -1   -1   -1   -1   -1   
-1   -1   0   1   0   0   0   0   0   0   0   0   0   1   0   0   0   1   0   0   0   0   0   0   0   1   0   -1   -1   
-1   -1   0   -1   1   -1   0   -1   1   -1   1   -1   0   -1   0   -1   0   -1   0   -1   1   -1   0   -1   0   -1   0   -1   -1   
-1   -1   0   0   0   0   0   1   0   0   0   1   0   0   0   1   0   0   0   0   0   1   0   1   0   1   0   -1   -1   
-1   -1   1   -1   1   -1   1   -1   0   -1   1   -1   1   -1   1   -1   0   -1   1   -1   1   -1   0   -1   0   -1   0   -1   -1   
-1   -1   0   0   0   0   0   0   0   1   0   0   0   0   0   0   0   1   0   0   0   0   0   1   0   1   0   -1   -1   
-1   -1   0   -1   1   -1   1   -1   0   -1   0   -1   1   -1   1   -1   1   -1   0   -1   0   -1   1   -1   1   -1   0   -1   -1   
-1   -1   0   0   0   1   0   0   0   1   0   0   0   0   0   0   0   1   0   1   0   1   0   0   0   0   0   -1   -1   
-1   -1   1   -1   0   -1   1   -1   1   -1   1   -1   1   -1   0   -1   0   -1   0   -1   1   -1   0   -1   1   -1   1   -1   -1   
-1   -1   0   1   0   0   0   1   0   0   0   0   0   0   0   1   0   1   0   0   0   0   0   1   0   0   0   -1   -1   
-1   -1   0   -1   1   -1   0   -1   0   -1   0   -1   1   -1   0   -1   0   -1   1   -1   1   -1   1   -1   0   -1   0   -1   -1   
-1   -1   0   0   0   1   0   0   0   1   0   1   0   0   0   1   0   1   0   0   0   1   0   0   0   1   0   -1   -1   
-1   -1   0   -1   1   -1   1   -1   1   -1   0   -1   1   -1   0   -1   0   -1   0   -1   0   -1   0   -1   1   -1   0   -1   -1   
-1   -1   0   0   0   0   0   0   0   1   0   0   0   1   0   1   0   1   0   1   0   1   0   0   0   1   0   -1   -1   
-1   -1   0   -1   1   -1   0   -1   0   -1   1   -1   0   -1   1   -1   0   -1   0   -1   0   -1   1   -1   0   -1   0   -1   -1   
-1   -1   0   1   0   0   0   1   0   0   0   1   0   1   0   0   0   1   0   1   0   0   0   1   0   1   0   -1   -1   
-1   -1   1   -1   0   -1   0   -1   1   -1   1   -1   0   -1   0   -1   1   -1   0   -1   1   -1   0   -1   0   -1   0   -1   -1   
-1   -1   0   0   0   1   0   1   0   0   0   0   0   1   0   0   0   1   0   1   0   1   0   0   0   1   0   -1   -1   
-1   -1   0   -1   1   -1   0   -1   0   -1   1   -1   0   -1   1   -1   0   -1   0   -1   0   -1   1   -1   1   -1   0   -1   -1   
-1   -1   0   1   0   0   0   1   0   0   0   1   0   1   0   0   0   1   0   1   0   0   0   0   0   1   0   -1   -1   
-1   -1   0   -1   1   -1   0   -1   0   -1   0   -1   0   -1   0   -1   1   -1   0   -1   0   -1   1   -1   1   -1   0   -1   -1   
-1   -1   0   0   0   1   0   0   0   1   0   1   0   1   0   0   0   0   0   1   0   1   0   0   0   0   0   -1   -1   
-1   -1   1   -1   0   -1   0   -1   1   -1   0   -1   1   -1   1   -1   1   -1   1   -1   0   -1   0   -1   1   -1   1   -1   -1   
-1   -1   0   0   0   1   0   1   0   1   0   0   0   1   0   0   0   0   0   0   0   0   0   0   0   0   0   -1   -1   
-1   -1   0   -1   1   -1   0   -1   0   -1   1   -1   0   -1   1   -1   1   -1   1   -1   1   -1   1   -1   1   -1   1   -1   -1   
-1   -1   0   1   0   0   0   0   0   0   0   1   0   0   0   0   0   0   0   0   0   0   0   0   0   0   0   -1   -1   
-1   -1   -1   -1   -1   -1   -1   -1   -1   -1   -1   -1   -1   -1   -1   -1   -1   -1   -1   -1   -1   -1   -1   -1   -1   -1   -1   -1   -1   
-1   -1   -1   -1   -1   -1   -1   -1   -1   -1   -1   -1   -1   -1   -1   -1   -1   -1   -1   -1   -1   -1   -1   -1   -1   -1   -1   -1   -1   
